R 120000000 8000000
F 0, 150, 50
C 0, 120, 150        
WE ./textures/wall_1.xpm
SO ./textures/wall_2.xpm
NO ./textures/wall_3.xpm
EA ./textures/wall_4.xpm

S ./textures/sprite_1.xpm

   1111111             11111111111111
11100000001111      11100000S00000000111111111
   100000000001        110000000000000000000001
   100000000001          1000000000000000000001
   100000200000111        110000000000000000001
    100000000000021        1100000000020000011
    111100011111111      1100000011111011111
   10000000000000001    10000020000010000001
   10000222222000001    10000000000010000001
   10000222222000001111110000000000010000001
   10000222222000000000000000000000010000001
   1000000000000001111111111111100111000001
    11111110001111        10000000001000001
   1000000000000001       10022000001002001
    111111111111101       10000011111000001111
   10000000000000011111    11111100000000000001
   100000000200000000001  100000000000000000001
   1000000000000000000011110000002000000111111
   10000020000000000000000000000000000001
    111111111111111111111111111111111111
