R 1200 800
F 120, 170, 0
C 150, 120, 0
WE ./textures/1.xpm
SO ./textures/2.xpm
NO ./textures/3.xpm
EA ./textures/4.xpm
S ./textures/5.xpm

11111111111          11111111111111111
1110000000111111    11100000S000000001111111111
111100000000001111    1111000000000000000000001
   100000000001111       1000000000000000000001
   1000002000001111       110000000000000000001
   11000000000001        1110000000002000001111
   11111100011111111    11110000001111101111
   10000000000000001    10000020000010000001
   10000222222000001    10000000000010000001
   10000222222000001111110000000000010000001
   10000222222000000000000000000000010000001
   10000000000000011111111111111001110000011
   1111111100011111       10000000001000001
   1000000000000001       10022000001002001
   1111111111111101       100000111110000011111
   100000000000000111111  111111100000000000001
   100000000200000000001  100000000000000000001
   10000000000000000000111100000020000001111111
   10000020000000000000000000000000000001
   11111111111111111111111111111111111111
